name The Doomest Dungeon
win 3
#########################################
#............#####.......#######........#
###.....G##....##...##..###G######......#
#E###.........................#######..E#
#........###G........G########..........#
#....................E..................#
#########################################